#######
#...#@#
#+#...#
#######
-------
#######
#...###
#+#.*##
#######
