############
##@........#
###..+####+#
############
------------
############
##....#+...#
###+.+####+#
############
------------
############
##+...#+...#
###+..####*#
############
------------
############
##+.+.#....#
###...####.#
############
------------
############
##..+.######
###...######
############
