############
#.#........#
#.#.######.#
#.#....#...#
#.###.+#.#.#
#..*####.#.#
------------
############
#.#.#..#.#.#
#.#.#.##.#.#
#@#......#.#
#.#......#.#
############
------------
############
#.#........#
#.#.######.#
#.#....#...#
#.#....#...#
############
------------
############
#.#....*...#
#.#.######.#
#.#....#...#
#.#...+#...#
############
