############
#.#........#
#.#.######.#
#.#....#...#
#.###.+#.#.#
#...####.#.#
#.#.#..#.#.#
#.#.#.##.#.#
#@#......#.#
############
------------
############
#.#........#
#.#.######.#
#.#....#...#
#.###.+#.#.#
#...####.#.#
#.#.#..#.#.#
#.#.#.##.#.#
#.#......#*#
############
