############
#.#........#
#.#.######=#
#.#....#...#
#.###.+#.#.#
#..*####.#.#
------------
############
#.#.#..#.#=#
#.#.#.##.#.#
#@#......#.#
#.#......#.#
############
------------
############
#.#........#
#.#.######=#
#.#....#...#
#.#....#...#
############
------------
############
#.#....*...#
#.#.######=#
#.#....#...#
#.#...+#...#
############
