#########################
#@.....................##
#.........#+.......#....#
#.#+.....#..#......#...+#
#########################
-------------------------
#########################
#+++++++++#+++++++++++++#
#.........#.............#
#+++++++++##++++++++++++#
#########################
-------------------------
#########################
#....#.....+............#
#+##+#####.#.############
#########################
#########################
-------------------------
#########################
##..#......+...........*#
#+##+####################
#########################
#########################