#########################
#......#...........+....#
#.#.....###.####...+....#
#.#.....#+#.#+++#.......#
#.#.....#+#.#++++#......#
#.#.....#+#.#+++++#.....#
#+#.....#+#.#++++++#....#
#+#.....#+#.#+++++++#...#
#+#.....###.#++++++++#..#
#+#.........#+++++++++#.#
#+#################+++#.#
##########........#+++#.#
#........#.######.#+++#.#
#.######.#......#.#####.#
#.#......######.#.....#.#
#.#.#######...#.#####.#.#
#.#.########+##.....#.#.#
#.#...........#####.#.#.#
#.#################.#.#.#
#........+#+........#.#.#
##........#........#..#.#
#+#.......#.......#..##.#
#++#......#####..#..###.#
#+++#...........#.......#
#########################
-------------------------
#########################
#+++++++++++++++++++++++#
#+++++++++++++++++++++++#
#...+++..+...+++.....+++#
#.....+......++++....+++#
#............+++++...+++#
#+....++++++++++++++++++#
#+.+.........+++++++++++#
#+..........++++++++++++#
#++.........++++++++++++#
#+++........+......+++..#
#+++.+.+.+.+.+.+++++++.+#
#+....++.+.......+++++..#
#.....++...+......+++...#
#......+..+++++....++..+#
#..............+....+...#
#....+++++..+.......+...#
#.........+.............#
#...+.+++++++++++++.....#
#...++...+.++..........+#
#...++++...++++.....++++#
#+...+++++++++...+..+..+#
#++++++++++++++++++++++.#
#+++..+............+..++#
#########################
-------------------------
#########################
#.......................#
##.######.....#.#########
#.........#####+#.......#
##.####.......###....##.#
##.###........#.##..##..#
#..................##...#
#.##############..##....#
#................##.....#
#.################......#
#.............###.......#
#..######..+..##........#
#..#....#.....#.........#
#..#.##.#####...........#
#..#.##.....#############
#..#.######.............#
#..#..#+++#######..###..#
#..##..###+..........#..#
#..#+#...#####.......#..#
#..#++##....#######..#..#
#..#++++###.....##..##..#
##..#++++++####.....#..##
###..###############..###
####.................#++#
#########################
-------------------------
#########################
#+++++++++++++++++++++++#
#+++++++++++++++++++++++#
#...+++..+...+++.....+++#
#.....+......++++....+++#
#............+++++...+++#
#+....++++++++++++++++++#
#+.+.........+++++++++++#
#+..........++++++++++++#
#++.........++++++++++++#
#+++........+......+++..#
#+++.+.+.+.+.+.+++++++.+#
#+....++.+.......+++++..#
#.....++...+......+++...#
#......+..+++++....++..+#
#..............+....+...#
#....+++++..+.......+...#
#.........+.............#
#...+.+++++++++++++.....#
#...++...+.++..........+#
#...++++...++++.....++++#
#+...+++++++++...+..+..+#
#++++++++++++++++++++++.#
#+++..+............+..++#
#########################
-------------------------
#########################
#....##.................#
#.##..##...########.#.#.#
#..##..###...######.#.#.#
#...##..##..........#.#.#
#....##..############.#.#
#.....................#.#
#......##..##########.#.#
#.......##..#########.#+#
#.+......##...........#.#
#.........##..#######.#.#
#..........##..#++++#.#.#
#...............#+++#.#.#
#............##..#++#.#.#
#.............##..#+#.#+#
#....+.........##..##.#.#
#...............##..#.#.#
#................##...#.#
################..##..#.#
#..................##.#+#
#...................###.#
#..........+.........##+#
#.....................###
#..................+...+#
#########################
-------------------------
#########################
#.....................#+#
#.+++++++++++++++++++.#.#
#.#.................#.#.#
#.#.###############.#.#.#
#.#.#.............#.#.#.#
#.#.#.+++++++++++.#.#.#.#
#.#.#.#.........#.#.#.#.#
#.#.#.#.#######.#.#.#.#.#
#.#.#.#.#.....#.#.#.#.#.#
#.#.#.#.#.###.#.#.#.#.#.#
#+#+#+#+#+#+#+#+#+#+#+#+#
#.#.#.#.#.#.#.#.#.#.#.#.#
#.#.#.#.#.#...#.#.#.#.#.#
#.#.#.#.#.+++++.#.#.#.#.#
#.#.#.#.#.......#.#.#.#.#
#.#.#.#.#########.#.#.#.#
#.#.#.#...........#.#.#.#
#.#.#.+++++++++++++.#.#.#
#.#.#...............#.#.#
#.#.#################.#.#
#.#...................#.#
#.+++++++++++++++++++++.#
#.......................#
#########################
-------------------------
#########################
#+++++++++++++++++++++++#
#+++++++++++++++++++++++#
#####################+++#
#..................+#+++#
##.............######+++#
#####.##.....##+++++++++#
#+++#..##...#+++++++++++#
######..##.#++++++++++++#
#........#.#++++++++++++#
########.#.##############
########.#.............##
#........#.##.########.##
#.########.##.######+#.##
#.#................#+#.##
#.#.######.##.####.#+#.##
#.#.#++++#.........#+#.##
#.#.#########.########.##
#.#...........#++#.....##
#.######.########......##
#.........#++++#.......##
##.#####...#++#........##
##.#####....##.........##
#+.....................##
#########################
-------------------------
#########################
###########....##.......#
#............#..#######.#
#.#######....#..........#
#..#...#.....#....#####.#
##...##.....##.....##...#
#..###.....####.....###.#
#.#+#.........##.....##.#
#.##...####.....##....###
###..#########..####...##
##......................#
##.####################.#
#....#++#...##..........#
####.#++#.#.###..########
#+#...#+#.#...##..##..###
##.....##.#...#+#..##...#
#.......#.#.+.####..##..#
#######.#.#...##.....##.#
##......#.#...#####.....#
##......#.#.......#######
#.......#.#######.##++++#
#.#######.........##+...#
#.......#######.####+.@.#
#.....+.......#.........#
#########################
-------------------------
#########################
#...................#+++#
#..################.#+++#
##..#++#............#+++#
#.#..########.....#.#####
#..........##.....#.....#
#..##..##...##....###...#
##..##..##...###..##..#.#
#+#..##..##...#..##..##.#
#++#..##..##....##..##..#
#+++#..##..##..##..##...#
#++###..##..####..##....#
#+#.....#+#..##..##.....#
##..########....##......#
#..##......##..##.......#
#.##..##..##....##......#
#....##..##..##..##.....#
#...##..##..####..##....#
#..##..##..##..##..##...#
#.##..##..##+...##..##..#
###..##..##......##..##.#
##..##..##.......+##..###
#+.##..##############..##
####...................+#
#########################
-------------------------
#########################
#+..+........+###+.....+#
#..+*+.....#######......#
#...+....######+####....#
#.....+########.#####...#
#.....########..######..#
#...######.......######.#
#..####...##....#..####+#
#+###...###..#..##...####
####..####..##..####..###
###..####..#+#...####..##
###.####..####...####..##
#.......................#
##..##..#..+#.....#....##
##..#..########...###..##
##....#########...###..##
###..###########...##..##
##...###########...#..###
#.......#########....####
#...##....#####.......###
#...#####........#.....##
#..################...#+#
#+##################+##.#
######+.................#
#########################