#########################
#........+#####......####
#.##########....#########
#...............#########
#############.###########
##.....######.###########
######........###########
#####..##################
#####................+###
#####.###################
##....###############..##
####..........@.........#
#########################
-------------------------
#########################
#########+###############
#########################
#########################
#########################
#########################
#########################
#########################
#####################+###
#####################.###
#+#####.................#
#.......................#
#########################
-------------------------
#########################
#.......................#
#.......................#
#.......................#
#..............+........#
#.......................#
#.......................#
#.......................#
#.......................#
#.......................#
#+......................#
#.......................#
#########################
-------------------------
#########################
#+......................#
#######################.#
##....................#.#
###############+#######.#
#.....................#.#
#.##################..#.#
#...###################.#
#..####################.#
#.......................#
#########################
#########################
#########################
-------------------------
#########################
#*..........#...........#
########..#########.###.#
##.###...##########.###+#
##.#####..........#.###.#
##....###########.#.#...#
##.###########....#.###.#
##..............#####...#
###############.#######.#
###.............#######.#
##..............#######.#
#.......................#
#########################
-------------------------
#########################
#+...........#..........#
#..........#....#......##
#.............#.......#+#
#####..############...#.#
####.....##########.###.#
###..#####..........###.#
###......##........##...#
##..######...########.#.#
##..###...###########.#.#
###.###.###############.#
###.....................#
#########################