#########################
#......#...........=....#
#.#.....###.####...=....#
#.#.....#=#.#===#.......#
#.#.....#=#.#====#......#
#.#.....#=#.#=====#.....#
#=#.....#=#.#======#....#
#=#.....#=#.#=======#...#
#=#.....###.#========#..#
#=#.........#=========#.#
#=#################===#.#
##########........#===#.#
#........#.######.#===#.#
#.######.#......#.#####.#
#.#......######.#.....#.#
#.#.#######...#.#####.#.#
#.#.########=##.....#.#.#
#.#...........#####.#.#.#
#.#################.#.#.#
#........=#=........#.#.#
##........#........#..#.#
#=#.......#.......#..##.#
#==#......#####..#..###.#
#===#...........#.......#
#########################
-------------------------
#########################
#=======================#
#=======================#
#...===..=...===.....===#
#.....=......====....===#
#............=====...===#
#=....==================#
#=.=.........===========#
#=..........============#
#==.........============#
#===........=......===..#
#===.=.=.=.=.=.=======.=#
#=....==.=.......=====..#
#.....==...=......===...#
#......=..=====....==..=#
#..............=....=...#
#....=====..=.......=...#
#.........=.............#
#...=.=============.....#
#...==...=.==..........=#
#...====...====.....====#
#=...=========...=..=..=#
#======================.#
#===..=............=..==#
#########################
-------------------------
#########################
#.......................#
##.######.....#.#########
#.........#####=#.......#
##.####.......###....##.#
##.###........#.##..##..#
#..................##...#
#.##############..##....#
#................##.....#
#.################......#
#.............###.......#
#..######..=..##........#
#..#....#.....#.........#
#..#.##.#####...........#
#..#.##.....#############
#..#.######.............#
#..#..#===#######..###..#
#..##..###=..........#..#
#..#=#...#####.......#..#
#..#==##....#######..#..#
#..#====###.....##..##..#
##..#======####.....#..##
###..###############..###
####.................#==#
#########################
-------------------------
#########################
#=======================#
#=======================#
#...===..=...===.....===#
#.....=......====....===#
#............=====...===#
#=....==================#
#=.=.........===========#
#=..........============#
#==.........============#
#===........=......===..#
#===.=.=.=.=.=.=======.=#
#=....==.=.......=====..#
#.....==...=......===...#
#......=..=====....==..=#
#..............=....=...#
#....=====..=.......=...#
#.........=.............#
#...=.=============.....#
#...==...=.==..........=#
#...====...====.....====#
#=...=========...=..=..=#
#======================.#
#===..=............=..==#
#########################
-------------------------
#########################
#....##.................#
#.##..##...########.#.#.#
#..##..###...######.#.#.#
#...##..##..........#.#.#
#....##..############.#.#
#.....................#.#
#......##..##########.#.#
#.......##..#########.#=#
#.=......##...........#.#
#.........##..#######.#.#
#..........##..#====#.#.#
#...............#===#.#.#
#............##..#==#.#.#
#.............##..#=#.#=#
#....=.........##..##.#.#
#...............##..#.#.#
#................##...#.#
################..##..#.#
#..................##.#=#
#...................###.#
#..........=.........##=#
#.....................###
#..................=...=#
#########################
-------------------------
#########################
#.....................#=#
#.===================.#.#
#.#.................#.#.#
#.#.###############.#.#.#
#.#.#.............#.#.#.#
#.#.#.===========.#.#.#.#
#.#.#.#.........#.#.#.#.#
#.#.#.#.#######.#.#.#.#.#
#.#.#.#.#.....#.#.#.#.#.#
#.#.#.#.#.###.#.#.#.#.#.#
#=#=#=#=#=#=#=#=#=#=#=#=#
#.#.#.#.#.#.#.#.#.#.#.#.#
#.#.#.#.#.#...#.#.#.#.#.#
#.#.#.#.#.=====.#.#.#.#.#
#.#.#.#.#.......#.#.#.#.#
#.#.#.#.#########.#.#.#.#
#.#.#.#...........#.#.#.#
#.#.#.=============.#.#.#
#.#.#...............#.#.#
#.#.#################.#.#
#.#...................#.#
#.=====================.#
#.......................#
#########################
-------------------------
#########################
#=======================#
#=======================#
#####################===#
#..................=#===#
##.............######===#
#####.##.....##=========#
#===#..##...#===========#
######..##.#============#
#........#.#============#
########.#.##############
########.#.............##
#........#.##.########.##
#.########.##.######=#.##
#.#................#=#.##
#.#.######.##.####.#=#.##
#.#.#====#.........#=#.##
#.#.#########.########.##
#.#...........#==#.....##
#.######.########......##
#.........#====#.......##
##.#####...#==#........##
##.#####....##.........##
#=.....................##
#########################
-------------------------
#########################
###########....##.......#
#............#..#######.#
#.#######....#..........#
#..#...#.....#....#####.#
##...##.....##.....##...#
#..###.....####.....###.#
#.#=#.........##.....##.#
#.##...####.....##....###
###..#########..####...##
##......................#
##.####################.#
#....#==#...##..........#
####.#==#.#.###..########
#=#...#=#.#...##..##..###
##.....##.#...#=#..##...#
#.......#.#.=.####..##..#
#######.#.#...##.....##.#
##......#.#...#####.....#
##......#.#.......#######
#.......#.#######.##====#
#.#######.........##=...#
#.......#######.####=.@.#
#.....=.......#.........#
#########################
-------------------------
#########################
#...................#===#
#..################.#===#
##..#==#............#===#
#.#..########.....#.#####
#..........##.....#.....#
#..##..##...##....###...#
##..##..##...###..##..#.#
#=#..##..##...#..##..##.#
#==#..##..##....##..##..#
#===#..##..##..##..##...#
#==###..##..####..##....#
#=#.....#=#..##..##.....#
##..########....##......#
#..##......##..##.......#
#.##..##..##....##......#
#....##..##..##..##.....#
#...##..##..####..##....#
#..##..##..##..##..##...#
#.##..##..##=...##..##..#
###..##..##......##..##.#
##..##..##.......=##..###
#=.##..##############..##
####...................=#
#########################
-------------------------
#########################
#=..=........=###=.....=#
#..=*=.....#######......#
#...=....######=####....#
#.....=########.#####...#
#.....########..######..#
#...######.......######.#
#..####...##....#..####=#
#=###...###..#..##...####
####..####..##..####..###
###..####..#=#...####..##
###.####..####...####..##
#.......................#
##..##..#..=#.....#....##
##..#..########...###..##
##....#########...###..##
###..###########...##..##
##...###########...#..###
#.......#########....####
#...##....#####.......###
#...#####........#.....##
#..################...#=#
#=##################=##.#
######=.................#
#########################
