#######
#.#.+##
#..+..#
##..=##
###..##
#...#*#
#######
-------
#######
#*#..##
#....##
##..=.#
###...#
##.@.##
#######
-------
#######
#.##+.#
###+.##
#..####
####..#
#*#..##
#######
-------
#######
#...+.#
#.#+###
#.###*#
#..####
#....##
#######
