#######
#*#..##
#...+##
##..=.#
###...#
##.@.##
#######