########################
#+.....................#
#.####################.#
#.####################.#
#.####################.#
#.####################.#
#.####################.#
#.####################.#
#.....................+#
#.####################.#
#.####...........#####.#
#.####.....@.....#####.#
#.####...........#####.#
#.####...........#####.#
#.#########.##########.#
#+.....................#
########################
------------------------
########################
#+.....................#
#.####################.#
#.####################.#
#.####.....=.....#####.#
#.####...........#####.#
#.####...........#####.#
#.#########.##########.#
#......................#
#.####################.#
#.####################.#
#.####################.#
#.####################.#
#.####################.#
#.####################.#
#+....................+#
########################
------------------------
########################
#+....................+#
#.####################.#
#.####################.#
#.####.....=.....#####.#
#.####...........#####.#
#.####...........#####.#
#.#########.##########.#
#.....................+#
#.####################.#
#.####################.#
#.####################.#
#.####################.#
#.####################.#
#.####################.#
#+....................+#
########################
------------------------
########################
#......................#
#.####################.#
#.####################.#
#.####.....=.....#####.#
#.####...........#####.#
#.####...........#####.#
#.#########.##########.#
#......................#
#.#########.##########.#
#.####...........#####.#
#.####...........#####.#
#.####...........#####.#
#.####.....*.....#####.#
#.####################.#
#......................#
########################
